#####################################
####                             ####
#### ##### #### ######## #### # #####
#### ###   #### #        #### #    ##
#### ### ###### # ########### #### ##
#### ### ###### #          ## #### ##
#### ###      # #########B### #### ##
#### ################################
####                             ####
################################ ####
#######A                         ####
#####################################