##B## ####
##      ##
###### ###
###      #
### #### #
### #    #
#   # ####
# ### ####
#A########