#########B####
#            #
# ########## #
# ########## #
# ########## #
# ########## #
#            #
############A#
